################
#S.....C..######
#.#######.######
#C........######
#########...E###
################
