################
#S.....C..######
#.#######.###C##
#C........######
#########...E###
################
